...###.....
..##.#.####
.##..###..#
##........#
#...@.*#..#
###..###..#
..#..#....#
.##.##...##
.#......##.
.#....&##..
.#######...
