######.....
#&*#.#.####
#...*###..#
##.*...#..#
#..@...#..#
###.......#
..#..#....#
.##......##
.####.####.
.#.....##..
.#######...