######.....
#..#.#.####
#....###..#
##.....#..#
#..@...#..#
###.......#
..#..#....#
.##...*..##
.#.##.####.
.#..&.*##..
.#######...