######.....
#..#.#.####
#....###..#
##.....#..#
#......#..#
###.......#
..#..#....#
.##.....@##
.#&##.####.
.#.....##..
.#######...